..............11..............44...................................................................11..................................
..............11..............44...................................................................11.......t__________________________
.....................22............................................................................tT.......[88888888888888888888888888
..............tT.....22.......tT...................................................................[]........22..33..44..44..33..22..11
..............[]..............[]........................................................................tT...22..33..44..44..33..22..11
.....................tT.................................................................................[].............................
.....................[].................................................................................[].............................
_________________________________________________________________________________T.....t_______________________________________________
888888888888888888888888888888888888888888888888888888888888888888888888888888888].....[88888888888888888888888888888888888888888888888
888888888888888888888888888888888888888888888888888888888888888888888888888888888].....[88888888888888888888888888888888888888888888888
888888888888888888888888888888888888888888888888888888888888888888888888888888888].....[88888888888888888888888888888888888888888888888
888888888888888888888888888888888888888888888888888888888888888888888888888888888].....[88888888888888888888888888888888888888888888888
...................22222................44444.....3333............22222........................2222....4444........1111111.............
...................22222................44444.....3333............22222........................2222....4444........1111111.............
...................22222................44444.....3333............22222................................................................
.............................t_______T............................................................................t________T...........
.........................tT..[8888888].................t________T..............................t__________T.......[88888888]...........
.........................[]............................[88888888]..............................[8888888888]............................
.......................................................................................................................................
___t.....T_____________________________________________________________________________________________________________________________
888].....[88888888888888888888888888888888888888888888888888888888888888888888888888888888888888888888888888888888888888888888888888888
888].....[88888888888888888888888888888888888888888888888888888888888888888888888888888888888888888888888888888888888888888888888888888
888].....[88888888888888888888888888888888888888888888888888888888888888888888888888888888888888888888888888888888888888888888888888888
.......................................................................................................................................
.......................................................................................................................................
.................................222222........44444444..........111...................................................................
......................11111......222222........44444444..........111.......222.........................................................
......................11111................................................222........444.....................3333333..................
...............................................t______T.........t___T.................444.....................3333333..................
................................t______T.......[888888].........[888].....t____T..............................3333333..................
.....................t_____T....[888888].......[888888]........tJ888].....[8888].....t____T............................................
_____________________J88888L____J888888L_______J888888L__t...T_J8888L_____J8888L_____J8888L____________________________________________
888888888888888888888888888888888888888888888888888888888]...[8888888888888888888888888888888888888888888888888888888888888888888888888
888888888888888888888888888888888888888888888888888888888]...[8888888888888888888888888888888888888888888888888888888888888888888888888